NO ./path_to_the_north_texture
SO ./path_to_the_south_texture
WE ./path_to_the_west_texture
EA ./path_to_the_east_texture

F 220,100,0
C 225,30,0

        1111111111111111111111111                     1111111111111111111111111
        1000000000000000000000001                     1000000000000000000000001
        1011000000000010000000001                     1011000000000010000000001
        1001000000000100000000001                     1001000000000100000000001
111111111011000000000000000000001             111111111011000000000000000000001
100000000011000001110111111111111             100000000011000001110111111111111
10000000000000000000000010001                 10000000000000000000000010001
11110000000000000101010010001                 11110000000000000101010010001
11000000000000000000000000001                 11000000000000000000000000001
10000000000000001100000010001                 10000000000000001100000010001
10000000000000001101010010001                 10000000000000001101010010001
1100000111111101111111111000111               1100000111111101111111111000111
1111011101  10101011  1010001                 1111011101  10101011  1010001
1111111111  11111111  1111111                 1111111111  11111111  1111111