NO BRICK_3D.xpm
EA BRICK_3D.xpm
WE BRICK_3D.xpm
SO BRICK_3D.xpm

F 69,191,85                           
C 131,227,218

1111111111111111111111111111
111111111N001100000000000011
1111111110101100000000000011
1100000111011101111111111011
1111111111111111111111111111
1111111110001100000000000011
1111111110101100000000000011
1111111111111111111111111111