NO BRICK_3D.xpm
EA BRICK_3D.xpm
WE BRICK_3D.xpm
SO BRICK_3D.xpm

F 69,191,85                           
C 131,227,218

        1111111111111111111111111
        1000000000110000000000001
        1011000001110000000000001
        1001000000000000000000001
111111111011000001110000000000001
1E0000000011000001110111111111111
11110111111111011100000010001
11110111111111011101010010001
11000000110101011100000010001
10000000000000001100000010001
10000000000000001101010010001
1100000111010101111101111000111
11110111 1110101 101111010001
11111111 1111111 111111111111
