NO no.xpm
SO so.xpm
WE we.xpm
EA ea.xpm

F 195,255,51
C 22,255,255

 1111111111111111111111111111
10000000000000000000000010001
10110000000000100000000010001
10010000000001000000000010001
11111111101100000000000000001
10000000001100000111011111111
10000000000101000000000010001
11110000000101000010101001001
11000000000101000000000000001
100000N0000000001100000010001
10000000000000001101010010001
11111111111111111111111111111 