111111111111111111111111111111111111111111111111111111111111111111111111111111111111
100000000000000000000000100000000000000000000000000000000000000000000000000000000001
100000000000000000000000000000000000100000000000000000000000000000000000000000000001
100000000000000000000000000000000000000000000000000000000010000000000000000000000101
100000000000000000000000000000000000000000000000000000000000000000000000000000000101
100010000000000100000000000000000000000000000000000000000000000000000000000000000001
100000000000000010000000000000000000000000000000000000000000000000000000000000000101
100000000000000000000000000000000000000000000000010000000000000000000000000000000101
100000000000000000000000000000000000000000000000000000000000000000000000000000000001
100000000000000000000000000000000000100000000000000000000000000000000000000000000001
100000000000000000000000000000000000000000000000000000000000000000000000000000000001
100000000000000000000000000000000000000000000000000000000000000000000000000000000001
100000000000000000000000000000000000000000000000000000000000000000000000000000000101
100000000000000000000000000000000000000000000000000000000000000000000000000000000101
100010000000000100000000000000000000000000000000010000000000100000000000000000000001
100000000000000010000000000000000000000000000000000000000000000000000000000000000101
100000000000000000000000000000000000000000000000000000000000000000000000000000000101
100000000000000000000000000000000000000000000000000000000000000000000000000000000001
100000000000000000000000000000000000000000000000000000000000000000000000000000000001
100000000000000000000000000000000100000000000000000000000000000000000000000000000001
100000000000000000000000000000000000000000000000000000000000000000000000000000000001
100000000000000000000000000000000000000000000000000100000000000000000000000000000101
100000000000000000000000000000000000000000000000000000000000000000000000000000000101
100010000000000100000000000000000000000000000000000000000000100000000000000000000001
100000000000000010000000000000000000000000000000000000000000000000000000000000000101
100000000000000000000000000000000000000000000000000000000000000000000000000000000101
100000000000000000000000000000000000100000000000000000000000000000000000000000000001
100000000000000000000000000000000000000000000000000000000000000000000000000000000001
111111111111111111111111111111111111111111111111111111111111111111111111111111111111