NO tex0.xpm
SO texbb.xpm
WE texbb.xpm
EA texbb.xpm
F 195,255,51
C 0,255,255

11111111111111111111111111111
10000000000000000000000010001
10110000000000100000000010001
10010000000001000000000010001
11111111101100000000000000001
10000000001100000111011111111
10000000000000000000000010001
111100000000W0000010101001001
11000000000000000000000000001
10000000000000001100000010001
10000000000000001101010010001
11111111111111111111111111111 